#######     ############
#.....#     #..........#
#.....#######..........#
#......................D
#############..........#
            #..........#
            #..........#
            #..........#
            #..........#
            #..........#
            ######.#####
                 #.#    
            ######.#####
            #..........#
            #..........#
            ############